5
........o....o........
....o............o....
.o.....o....o.........
.........o.........o..
....o......o..........
